  1111111
110001111
  10000001
  10000001
  100000011111
   100000000011
  1111100000111
  1111100000111
  1110000001111
  111111111111
